ㄱ=a
ㄲ=A
ㄴ=b
ㄷ=c
ㄸ=C
ㄹ=d
ㅁ=e
ㅂ=f
ㅃ=F
ㅅ=g
ㅆ=G
ㅇ=h
ㅈ=i
ㅉ=I
ㅊ=j
ㅋ=k
ㅌ=l
ㅍ=m
ㅎ=n
ㅏ=o
ㅑ=p
ㅓ=q
ㅕ=r
ㅗ=s
ㅛ=t
ㅜ=u
ㅠ=v
ㅡ=w
ㅣ=x
ㅐ=y
ㅒ=Y
ㅔ=z
ㅖ=Z
~=띄어쓰기
_=종성표현